border_size=1
usage=map

Xu, Xu, Xu, Uu, Uu, Uu, Uu, Uu, Uu, Uu, Uh, Uu, Uh, Uu, Uu, Uu, Uu, Xu, Xu, Xu, Xu, Xu, Mm^Xm, Mm^Xm, Mm^Xm, Mm^Xm, Mm^Xm, Mm^Xm, Mm^Xm, Mm^Xm, Mm^Xm, Mm, Mm^Xm, Mm^Xm, Mm^Xm, Mm^Xm, Mm^Xm, Mm^Xm, Mm^Xm, Mm^Xm, Mm^Xm, Mm^Xm, Mm^Xm, Mm^Xm
Xu, Xu, Uh, Uu, Re, Uu, Re, Re, Uu, Uu, Uh, Uh, Uh, Uu, Uu, Uu, Uu, Uh, Uh, Uh, Xu, Xu, Mm, Mm, Mm, Mm, Mm, Mm, Mm, Mm^Xm, Mm, Mm^Xm, Mm, Mm, Mm, Mm, Mm, Mm, Mm, Mm, Mm, Mm, Mm, Mm
Uu, Xu, Rd, Uu, Uu, Re, Uu, Uu, Uu, Uu, Uu, Uu, Uu, Uu, Uu, Re, Re, Re, Uh, Uh, Xu, Mm, Ai, Mm, Mm, Mm, Mm, Mm, Mm, Mm, Mm, Mm, Mm, Mm, Mm, Mm, Mm, Mm, Mm, Mm, Hh, Mm, Mm, Mm
Uu, Rd, Qxu, Uu, Qxu, Uu, Uu, Uu, Uu^Uf, Uu, Uh, Re, Re, Uu, Uu^Vu, Uu, Uu, Uu, Xu, Xu, Mm, Mm, Ai, Ai, Mm, Mm, Mm, Mm, Mm, Mm, Hh, Hh, Hh, Mm, Mm, Mm, Hh, Mm, Mm, Hh, Hh, Mm, Mm, Mm
Xu, Rd, Rd, Qxu, Qxu, Qxu, Qxu, Qxu^Bs|, Qxu, Uu, Uu, Uh, Re, Uu, Qxu, Qxu, Uu^Uf, Uu, Xu, Xu, Mm, Ai, Ai, Ww, Ww, Ww, Ww, Hh, Mm, Mm, Mm, Mm, Hh, Mm, Hh, Mm, Hh, Mm, Hh, Hh, Hh, Hh, Hh, Mm
Xu, Rd, Xu, Rd, Uu, Uh, Uu, Uu, Qxu, Uu, Uu^Uf, Uu, Re, Qxu, Uu, Re, Uh, Uu, Uh, Xu, Mm^Xm, Mm, Mm, Ai, Hh, Mm, Mm, Ww, Ww, Hh, Hh, Hh, Hh, Hh, Hh, Hh, Hh, Hh, Hh, Hh, Hh, Hh, Hh, Hh
Xu, Uu, Uu^Uf, Xu, Uu, Uu, Re, Uu, Uu, Qxu, Qxu, Uu, Qxu, Qxu^Bs\, Re, Re, Uh, Uh, Uh, Xu, Mm^Xm, Mm, Mm, Mm, Mm, Mm, Mm, Hh, Ww, Hh, Ww, Hh, Hh, Hh, Gs^Fp, Hh, Gs^Fp, Hh, Hh, Gs^Fp, Gs^Fp, Gs^Fp, Gs^Fp, Hh
Xu, Uu, Uu^Uf, Uh, Uu, Uu^Uf, Qxu, Re, Xu, Uu, Uu, Qxu, Uu, Uu, Uu, Uu, Uu, Uu, Xu, Xu, Mm^Xm, Mm^Xm, Mm, Mm, Mm, Mm, Hh, Hh, Hh, Ww, Hh, Ww, Gs^Fp, Gs^Fp, Gs^Fp, Gs^Fp, Gs^Fp, Gs^Fp, Gs^Fp, Gs^Fp, Gs^Fp, Gs^Fp, Gs^Fp, Gs^Fp
Xu, Uu, Uu^Vud, Rd, Uu, Qxu, Qxu, Re, Uu, Uu, Uu, Qxu, Uu, Uh, Xu, Re, Uu^Uf, Uu^Uf, Xu, Xu, Mm^Xm, Mm^Xm, Mm, Mm, Mm, Hh, Hh, Hh, Gs^Fp, Hh, Gs^Fp, Ww, Gs^Fp, Gs^Fp, Gs^Fp, Gs^Fp, Gs^Fp, Gs^Fp, Gs^Fp, Gs^Fp, Gs^Fp, Gs^Fp, Gs^Fp, Gs^Fp
Xu, Xu, Xu, Uu, Rd, Xu, Xu, Uu, Rd, Rd, Uu, Qxu, Qxu^Bs/, Re, Re, Uu, Uu^Vu, Uu^Uf, Xu, Xu, Mm, Mm, Mm, Mm, Gs^Fp, Hh, Hh, Gs^Fp, Gs^Fp, Gs^Fp, Gs^Fp, Ww, Gs^Fp, Gs^Fp, Gs^Fp, Gs^Fp, Gs^Fp, Gs^Fp, Gs^Fp, Gs^Fp, Gs^Fp, Gs^Fp, Gs^Fp, Gs^Fp
Xu, Xu, Uu, Rd, Xu, Rd, Rd, Uu, Uu, 3 Uu^Uf, Uu, Uu, Uu, Qxu, Uu, Uu, Xu, Xu, Mm^Xm, Mm^Xm, Mm, Mm, Gs^Fp, Hh, Hh, Hh, Gs^Fp, Hh, Gs^Fp, Gs^Fp, Gs^Fp, Ww, Gs^Fp, Gs^Fp, Gs^Fp, Gs^Fp, Gs^Fp, Gs^Fp, Gs^Fp, Gg^Fet, Gs^Fp, Gs^Fp, Gs^Fp, Gs^Fp
Xu, Xu, Uu, Xu, Xu, Uu^Uf, Uu, Uu, Rd, Uu, Uu, Uu, Xu, Xu, Xu, Xu, Mm^Xm, Mm^Xm, Mm, Mm, Mm, Hh, Gs^Fp, Hh, Gs^Fp, Gs^Fp, Gs^Fp, Gs^Fp, Gs^Fp, Gs^Fp, Gs^Fp, Ww, Ww, Gs^Fp, Ss, Gs^Fp, Gs^Fp, Gs^Fp, Gs^Fp, Gs^Fp, Gs^Fp, Gs^Fp, Gs^Fp, Gs^Fp
Qxu, Xu, Xu, Uh, Xu, Uh, Uh, Uu, Uu, Uu, Rd, Xu, Uh, Rd, Rd, Xu, Xu, Mm^Xm, Mm, Mm, Hh, Hh, Hh, Gs^Fp, Gs^Fp, Gs^Fp, Gs^Fp, Gs^Fp, Gs^Fp, Gs^Fp, Gs^Fp, Gs^Fp, Gs^Fp, Ww, Ww, Gs^Fp, Ww, Gs^Fp, Gs^Fp, Gs^Fp, Gs^Fp, Gs^Fp, Gs^Fp, Gs^Fp
Qxu, Qxu, Qxu, Re, Xu, Xu, Xu, Xu, Xu, Xu, Xu, Rd, Xu, Xu, Rd, Xu, Mm, Mm, Mm, Hh, Gs^Fp, Hh, Gs^Fp, Gs^Fp, Gs^Fp, Gs^Fp, Gs^Fp, Gs^Fp, Gs^Fp, Gs^Fp, Gs^Fp, Gs^Fp, Gs^Fp, Gs^Fp, Gs^Fp, Ww, Gs^Fp, Ww, Ww, Gs^Fp, Gs^Fp, Gs^Fp, Gs^Fp, Gs^Fp
Uu, Qxu, Qxu, Re, Re, Uu^Vud, Re, Uu, Re, Uh, Uu, Xu, Uu^Vud, Uu, Rd, Xu, Mm^Xm, Mm, Hh, Hh, Gs^Fp, Hh, Gs^Fp, Gs^Fp, Gs^Fp, Gg^Fet, Gs^Fp, Gs^Fp, Gs^Fp, Gs^Fp, Gs^Fp, Gs^Fp, Gs^Fp, Gs^Fp, Gs^Fp, Gs^Fp, Gs^Fp, Gs^Fp, Ww, Gs^Fp, Gs^Fp, Gs^Fp, Gs^Fp, Gs^Fp
Qxu, Qxu, Uu^Uf, Uu, Uu, Re, Uu, Rd, Uu, Uu, Uu, Re, Re, Uu, Xu, Xu, Mm, Mm, Hh, Hh, Gs^Fp, Gs^Fp, Gs^Fp, Gs^Fp, Gs^Fp, Gs^Fp, Gs^Fp, Gs^Fp, Gs^Fp, Gs^Fp, Gg^Fet, Gs^Fp, Gs^Fp, Gs^Fp, Gs^Fp, Gs^Fp, Gs^Fp, Gs^Fp, Ww, Gs^Fp, Gs^Fp, Gs^Fp, Gs^Fp, Gs^Fp
Qxu, Qxu, Uh, Uu, Xu, Xu, Xu, Uu, Re, Re, Qxu, Qxu, Qxu, Qxu, Uu^Uf, Xu, Xu, Mm, Hh, Gs^Fp, Gs^Fp, Gs^Fp, Gs^Fp, Gs^Fp, Gs^Fp, Gs^Fp, Gs^Fp, Gs^Fp, Gs^Fp, Gs^Fp, Gs^Fp, Gs^Fp, Gs^Fp, Gs^Fp, Gs^Fp, Gs^Fp, Gs^Fp, Ss, Ss, Ww, Ww, Gs^Fp, Re, Re
Xu, Xu, Xu, Xu, Xu, Re, Re, Uu, Xu, Re, Re, Uu, Uu^Uf, Re, Uu^Uf, Xu, Xu, Mm, Hh, Gs^Fp, Gs^Fp, Gs^Fp, Gs^Fp, Rd, Gs^Fp, Gs^Fp, Gs^Fp, Gs^Fp, Gs^Fp, Gs^Fp, Gs^Fp, Gs^Fp, Gs^Fp, Gs^Fp, Gs^Fp, Gs^Fp, Gs^Fp, Gs^Fp, Gs^Fp, Gs^Fp, Re, Ww^Bw/, Ww, Gs^Fp
Xu, Re, Re, Re, Re, Re, Uu, Re, Xu, Xu, Uh, Uu^Uf, Uh, Uu^Uf, Xu, Xu, Mm, Mm, Hh, Gs^Fp, Gs^Fp, Gs^Fp, Gs^Fp, Gs^Fp, Gs^Fp, Gs^Fp, Gs^Fp, Gs^Fp, Gs^Fp, Gs^Fp, Gs^Fp, Gs^Fp, Gs^Fp, Gs^Fp, Gs^Fp, Gs^Fp, Gs^Fp, Gs^Fp, Re, 1 Re, Gs^Fp, Gs^Fp, Gs^Fp, Ww
Uu, Re, Re, Re, Uu, Uu, Re, Uu, Uu, Xu, Xu, Uh, Xu, Xu, Mm^Xm, Mm, Mm, Hh, Gs^Fp, Gs^Fp, Gs^Fp, Gs^Fp, Gs^Fp, Gs^Fp, Gs^Fp, Gs^Fp, Gs^Fp, Gs^Fp, Gs^Fp, Gs^Fp, Gs^Fp, Gs^Fp, Gs^Fp, Gs^Fp, Gs^Fp, Gs^Fp, Re, Re, Gs^Fp, Gs^Fp, Gs^Fp, Gs^Fp, Gs^Fp, Gs^Fp
Uu, Re, Re, Re, Re, Re, Xu, Re, Re, Uu, Xu, Xu, Mm, Mm, Mm, Mm, Hh, Hh, Gs^Fp, Gg^Fet, Gs^Fp, Gs^Fp, Gs^Fp, Gs^Fp, Gs^Fp, Gs^Fp, Gg, Hh, Hh, Gs^Fp, Gs^Fp, Gs^Fp, Gs^Fp, Gs^Fp, Gs^Fp, Gs^Fp, Re, Gs^Fp, Gs^Fp, Gs^Fp, Gs^Fp, Gs^Fp, Gs^Fp, Gs^Fp
Uu, Uu^Uf, Uu^Vud, Re, Re, Re, Xu, Xu, Xu, Re, Xu, Mm, Mm, Mm, Hh, Mm, Hh, Hh, Gs^Fp, Gs^Fp, Gs, Gs^Fp, Gs^Fp, Gs^Fp, Gs^Fp, Gs^Fp, Gg, Hh, Hh, Gs^Fp, Gs^Fp, Gs^Fp, Gs^Fp, Gs^Fp, Re, Re, Gs^Fp, Gs^Fp, Gs^Fp, Gs^Fp, Gs^Fp, Gs^Fp, Gs^Fp, Gs^Fp
Xu, Uu^Uf, Xu, Xu, Xu, Xu, Xu, Xu, Mm^Xm, Re, Re, Mm, Mm, Hh, Gs^Fp, Hh, Gs^Fp, Gs^Fp, Gs^Fp, Gs^Fp, Gs^Fp, Gs, Gs^Fp, Gs^Fp, Gs^Fp, Gs^Fp, Gs^Fp, Gs^Fp, Gs^Fp, Gs^Fp, Gs^Fp, Gs^Fp, Re, Re, Gs^Fp, Gs^Fp, Gs^Fp, Gs^Fp, Gs^Fp, Gs^Fp, Gs^Fp, Gs^Fp, Gs^Fp, Gs^Fp
Mm^Xm, Xu, Mm^Xm, Mm, Mm^Xm, Xu, Mm^Xm, Xu, Mm, Mm, Re, Re, Mm, Hh, Gs^Fp, Gs^Fp, Gs^Fp, Gs^Fp, Gs^Fp, Gs^Fp, Gg^Efm, Gs, Gg^Efm, Gs^Fp, Gs^Fp, Gs^Fp, Gs^Fp, Gs^Fp, Gs^Fp, Gs^Fp, Re, Re, Gs^Fp, Gs^Fp, Gs^Fp, Gs^Fp, Gs^Fp, Gs^Fp, Gs^Fp, Gs^Fp, Gs^Fp, Hh, Gs^Fp, Gs^Fp
Mm^Xm, Mm^Xm, Mm, Mm^Xm, Mm^Xm, Mm, Mm, Mm, Mm, Mm, Re, Mm, Hh, Hh, Gs^Fp, Gg^Efm, Gs^Fp, Gs^Fp, Gs^Fp, Gs^Fp, Gg^Efm, Gg^Efm, Gg^Efm, Gg^Efm, Gg^Efm, Gs^Fp, Gs^Fp, Gs^Fp, Gs^Fp, Re, Gs^Fp, Gs^Fp, Gs^Fp, Gs^Fp, Gs^Fp, Gs^Fp, Hh, Gs^Fp, Gs^Fp, Gs^Fp, Gs^Fp, Hh, Gs^Fp, Gs^Fp
Mm^Xm, Mm^Xm, Mm, Mm^Xm, Mm, Mm, Mm, Hh, Hh, Hh, Gs, Hh, Gs, Gs^Fp, Gs^Fp, Gs^Fp, Gs^Fp, Gs^Fp, Gs^Fp, Gs^Fp, Gg^Efm, Gg^Efm, Gg^Vh, Gg^Efm, Gg^Efm, Gg^Efm, Gs^Fp, Gs, Gs^Fp, Re, Gs^Fp, Gs^Fp, Gs^Fp, Gs^Fp, Gs^Fp, Gs^Fp, Hh, Gs^Fp, Gs^Fp, Gs^Fp, Gs^Fp, Gs^Fp, Gs^Fp, Gs^Fp
Mm^Xm, Mm, Mm, Mm, Hh, Mm, Hh, Hh, Gs^Fp, Gs^Fp, Gs^Fp, Gs^Fp, Gs^Fp, Gs^Fp, Gs, Gs, Gs, Gs^Fp, Gs^Fp, Gs^Fp, Gg^Efm, Gg^Efm, Gg^Efm, Gg^Efm, Gg^Efm, Gg^Efm, Gs, Gs, Gs^Fp, Re, Gs^Fp, Gs^Fp, Gs^Fp, Gs^Fp, Gs^Fp, Hh, Gs^Fp, Gs^Fp, Gs^Fp, Gs^Fp, Gs^Fp, Gs^Fp, Gs^Fp, Gs^Fp
Mm^Xm, Mm^Xm, Mm, Hh, Hh, Hh, Gg^Fet, Gs^Fp, Gs^Fp, Gs^Fp, Gs^Fp, Gs^Fp, Gs^Fp, Gs^Fp, Gg^Fet, Gs^Fp, Gs^Fp, Gs^Fp, Gs^Fp, Gg, Gs^Fp, Gg^Efm, Gs^Fp, Gg^Efm, Gs^Fp, Gs^Fp, Gs^Fp, Gs^Fp, Re, Re, Gs^Fp, Gs^Fp, Gs^Fp, Gs^Fp, Gs^Fp, Gs^Fp, Gs^Fp, Gs^Fp, Gs^Fp, Gs^Fp, Gs^Fp, Gs^Fp, Gs^Fp, Gs^Fp
Mm, Mm, Hh, Gs^Fp, Gs^Fp, Gs^Fp, Hh, Hh, Hh, Gs^Fp, Gs^Fp, Gs^Fp, Gs, Gs^Fp, Gs^Fp, Gs^Fp, Gs^Fp, Gs^Fp, Gs^Fp, Gs^Fp, Gs^Fp, Gs^Fp, Gs^Fp, Gs^Fp, Gs^Fp, Gs^Fp, Gs^Fp, Re, Gs^Fp, Gs^Fp, Gs^Fp, Gs^Fp, Gs^Fp, Gs^Fp, Gs^Fp, Gs^Fp, Gs^Fp, Gs^Fp, Gs^Fp, Gg^Fet, Gs^Fp, Gs^Fp, Gs^Fp, Gs^Fp
Hh, Hh, Gs^Fp, Gs^Fp, Gs^Fp, Gs^Fp, Gs^Fp, Hh, Gs^Fp, Gs^Fp, Gs^Fp, Gs^Fp, Gs^Fp, Gs^Fp, Gs, Gs^Fp, Gs^Fp, Gs^Fp, Gs^Fp, Gs^Fp, Gs^Fp, Gs^Fp, Gs^Fp, Gs^Fp, Gs^Fp, Gs^Fp, Gs^Fp, Re, Gs^Fp, Gs^Fp, Gs^Fp, Gs^Fp, Gs^Fp, Gs^Fp, Gs^Fp, Gs^Fp, Gs^Fp, Gs^Fp, Gs^Fp, Gs^Fp, Gs^Fp, Gs^Fp, Gs^Fp, Gs^Fp
Gs^Fp, Gs^Fp, Gs^Fp, Gs^Fp, Gs^Fp, Gs^Fp, Gs^Fp, Gs^Fp, Gs^Fp, Gs^Fp, Gs^Fp, Gs^Fp, Gs^Fp, Gs, Gs^Fp, Gs^Fp, Gs^Fp, Gs^Fp, Gs^Fp, Gs^Fp, Gs^Fp, Gs^Fp, Gs^Fp, Gs^Fp, Gs^Fp, Gs^Fp, Gs^Fp, Re, Gs^Fp, Gs^Fp, Gs^Fp, Gs^Fp, Gs^Fp, Gs^Fp, Gs^Fp, Gs^Fp, Gs^Fp, Gs^Fp, Gs^Fp, Gs^Fp, Gs^Fp, Gs^Fp, Gs^Fp, Gs^Fp
Gs^Fp, Gs^Fp, Gs^Fp, Gs^Fp, Gs^Fp, Gs^Fp, Gs^Fp, Gs^Fp, Gs^Fp, Gs^Fp, Gs^Fp, Gs^Fp, Gs^Fp, Gs^Fp, Gs^Fp, Gs^Fp, Gs^Fp, Gs^Fp, Gs^Fp, Gs^Fp, Gs^Fp, Gs^Fp, Gs^Fp, Gs^Fp, Gs^Fp, Gs^Fp, Gs^Fp, Re, Gs^Fp, Gs^Fp, Gs^Fp, Gs^Fp, Gs^Fp, Gs^Fp, Gs^Fp, Gs^Fp, Gs^Fp, Gs^Fp, Gs^Fp, Gs^Fp, Gs^Fp, Gs^Fp, Gs^Fp, Gs^Fp
