border_size=1
usage=map

Gll^Fp      , Ss          , Gll^Fp      , Ss          , Gll^Fp      , Gg          , Gg          , Gll^Fp      , Gll^Fp      , Gll^Fp      , Gll^Fp      , Gll^Fp      , Gll^Fp      , Gll^Fp      , Gll^Fp      , Gll^Fp      , Gll^Fp      , Gll^Fp      , Gll^Fp      , Gll^Fp      , Gll^Fp      , Gll^Fp      , Gll^Fp      , Gll^Fp      , Gll^Fp      , Gll^Fp      , Gll^Fp      , Gll^Fp      , Gll^Fp      , Gll^Fp      , Gll^Fp      , Gll^Fp      , Gll^Fp      , Gll         , Gs          , Gll^Fp      , Gg^Efm      , Gg          
Ww          , Gg          , Rb          , Gg          , Gd^Vhr      , Gll^Fp      , Gll         , Gll^Fp      , Gll^Fp      , Gll^Fp      , Gll         , Gll^Fp      , Gll^Fp      , Gll^Fp      , Gll^Fp      , Gll^Fp      , Gll         , Gll         , Gd^Em       , Gll^Fp      , Gll^Fp      , Gll^Fp      , Gll^Fp      , Gg^Fet      , Gll^Fp      , Gll^Fp      , Gll^Fp      , Gll^Fp      , Gll^Em      , Gll^Fp      , Gll^Fp      , Gll^Fp      , Gll^Fp      , Gll^Es      , Gll^Fp      , Gs^Es       , Gll^Fp      , Gg^Efm      
Gg          , Ww          , Ww          , Rb          , Rb          , Rb          , Gd          , Gll^Fp      , Gll^Fp      , Gg          , Gg^Efm      , Gll         , Gll         , Gll^Fp      , Gd          , Gll^Em      , Gll^Fp      , Gll^Em      , Gll^Fp      , Gll^Fp      , Hh^Fp       , Gll^Fp      , Gll^Fp      , Gll^Fp      , Gll^Fp      , Gll^Fp      , Sm          , Sm          , Sm          , Gll^Fp      , Gll^Fp      , Gll^Fp      , Gll^Fp      , Gll^Fp      , Gll^Fp      , Gg^Es       , Gg          , Gg          
Gll^Fp      , Sm          , Sm          , Ww          , Gg          , Gg          , Md          , Md          , Md          , Gll^Fp      , Gg^Efm      , Gg^Fet      , Gs^Es       , Gll         , Gll^Fp      , Gll^Fp      , Hh^Fp       , Gll^Fp      , Gll^Fp      , Gll^Fp      , Hh^Fp       , Hh^Fp       , Gg          , Gd          , Gg          , Gll^Fp      , Wwf         , Sm          , Ww^Ewl      , Sm          , Gll^Efm     , Gll^Fp      , Gll^Fp      , Gll^Fp      , Gg          , Gg          , Gg          , Gg^Efm      
Gll^Fp      , Gg          , Gg          , Wwf         , Ww          , Hh^Fp       , Hh          , Md          , Hh          , Hh^Fp       , Gg^Efm      , Gs          , Gll^Fp      , Gll         , Gll^Fp      , Gll^Fp      , Hh^Fp       , Hh^Fp       , Gll^Fp      , Gll^Fp      , Gll^Em      , Gs^Vl       , Ww          , Wwf         , Ww^Bw/      , Gg          , Ww^Bw\      , Ww          , Ww          , Wwf         , Gll^Efm     , Gll^Fp      , Gll^Fp      , Gs          , Gg          , Gg          , Gg^Efm      , Gg^Efm      
Gg          , Gll^Fp      , Gll^Fp      , Gll^Fp      , Mm^Xm       , Ww          , Gg^Efm      , Hh^Fp       , Gll^Fp      , Gg^Es       , Gll^Fp      , Gll^Fp      , Gll^Fp      , Gs          , Gll         , Gll^Fp      , Gll^Fp      , Gll^Fp      , Gll^Fp      , Gll^Fp      , Gll^Fp      , Ds          , Ds          , Ww          , Ww          , Ww          , Ww          , Gg          , Wwf         , Wwf         , Gll^Fp      , Gll^Fp      , Gll^Fp      , Gll^Fp      , Gs          , Gg          , Gg          , Gg^Efm      
Ww          , Gg          , Gg^Efm      , Hh^Fp       , Ww          , Ww          , Hh^Fp       , Hh^Fp       , Re          , Re          , Chr         , Mm          , Hh^Fp       , Gg^Es       , Gll^Fp      , Gs          , Gs          , Gll^Fp      , Gll^Fp      , Gll^Em      , Gll^Em      , Gll^Fp      , Gg          , Gg          , Wwf         , Ww          , Gg^Efm      , Gg^Efm      , Gg^Efm      , Gll^Fp      , Gll^Fp      , Gll^Fp      , Gs          , Gg          , Gg          , Gg          , Gg          , Gg          
Gg^Efm      , Ww          , Gg^Efm      , Ww          , Gg^Efm      , Hh^Fp       , Md          , Hhd         , Rb          , Hhd         , Md          , Hh          , Hh^Fp       , Gll^Fp      , Gg          , Gg          , Gll         , Gll^Fp      , Gll^Fp      , Gll^Em      , Gll^Fp      , Gll^Fp      , Gll^Em      , Gll^Fp      , Gll^Fp      , Gll^Fp      , Gg          , Gll^Fp      , Gg^Efm      , Gg          , Gg          , Gs          , Gll^Fp      , Gll^Fp      , Gg^Es       , Gg^Es       , Gg^Es       , Gg          
Gg^Efm      , Ww          , Ww          , Ww          , Gg^Es       , Hh^Es       , Hhd         , Mm          , Rb          , Hhd         , Hhd         , Hh^Es       , Gs^Es       , Gg^Efm      , Gll^Fp      , Gs          , Gs          , Gll^Fp      , Gll^Fp      , Gg^Fet      , Gll^Fp      , Gll^Fp      , Gd          , Gll^Fp      , Gll         , Gll^Fp      , Gs^Vh       , Gg          , Gg^Efm      , Gg^Fet      , Gg^Efm      , Gg          , Gg          , Gg          , Gg^Es       , Gg^Es       , Gs          , Gg          
Gll^Fp      , Gg^Efm      , Gg          , Gg^Es       , Gll^Es      , Hhd         , Rb          , Mm          , Hhd^Vhhr    , Chr         , Ww          , Hh          , Hh^Fp       , Gg          , Gg^Efm      , Gll^Fp      , Gs          , Gll         , Gll         , Gd^Em       , Gll^Fp      , Gll^Fp      , Gll^Fp      , Gll^Fp      , Gll^Fp      , Gg          , Gg^Efm      , Gg          , Gg^Efm      , Gg          , Gg          , Gg          , Gs          , Gs^Es       , Gs          , Gs^Es       , Gs          , Gg          
Gll^Fp      , Gll^Fp      , Gs          , Gd^Vhr      , Rb          , Rb          , Mm^Xm       , Rb          , Rb          , Chr         , 1 Khr       , Chr         , Hh^Fp       , Gg^Es       , Gll^Fp      , Gg^Es       , Gg          , Gll         , Gll         , Gll^Fp      , Gll^Fp      , Gll         , Gll         , Gll^Fp      , Gs          , Gs          , Gg^Es       , Gg          , Gg          , Gg          , Gg          , Gg          , Gs          , Gs          , Gs          , Gs          , Gd          , Gs          
Gll^Fp      , Gll^Fp      , Rb          , Rb          , Hh^Fp       , Hhd         , Hh          , Mm          , Hhd         , Hhd         , Chr         , Hh          , Hh          , Hh^Fp       , Gg          , Gll^Fp      , Gs          , Gs          , Gll         , Gll^Fp      , Gll^Fp      , Gd^Em       , Gll^Fp      , Gll         , Gs          , Gs          , Gg          , Gg          , Gs          , Gs          , Gs          , Gs          , Gs^Es       , Gd          , Rb          , Rb          , Rb          , Rb          
Gll^Fp      , Gll^Em      , Rb          , Gll^Fp      , Gs^Es       , Gll^Fp      , Hh^Fp       , Hh^Es       , Hh          , Hh          , Hh^Fp       , Hh^Fp       , Gg^Efm      , Gg^Efm      , Gll^Fp      , Gs^Es       , Gll         , Gll         , Gll^Fp      , Gll^Fp      , Gll^Fp      , Gll^Fp      , Gll^Fp      , Gll^Fp      , Gll         , Gs          , Gs          , Gs          , Gd          , Gd          , Gd          , Gs^Es       , Gd          , Gd          , Rb          , Re^Es       , Re          , Rb          
Gll^Fp      , Gll^Fp      , Rb          , Gll^Fp      , Gll^Fp      , Gg^Efm      , Hh^Fp       , Gll^Fp      , Gg^Es       , Gg^Es       , Gll^Fp      , Gg^Efm      , Gs          , Gs          , Gll^Fp      , Gs          , Gd          , Gd          , Gll^Fp      , Gll^Fp      , Gll^Fp      , Gd^Em       , Gd          , Gs^Vl       , Gll         , Gll^Fp      , Gd^Fmw      , Gs          , Gs^Fdw      , Gd          , Rb          , Rb          , Re          , Re          , Rb          , Ce          , Ce          , Rb          
Qxe         , Qxe         , Qxe^Bw|r    , Qxe         , Qxe         , Gll         , Gll^Fp      , Gs          , Gll         , Gs          , Gs^Es       , Gs          , Gs^Es       , Gll^Fp      , Gll         , Gll         , Gll^Fp      , Gd          , Gd          , Gll^Em      , Gd          , Gll         , Gd          , Gll^Es      , Gll         , Gd^Fmw      , Gs^Fdw      , Gs^Fdw      , Gll         , Gd          , Rb          , Rb          , Ce          , Re          , Re          , Ce          , Re^Vct      , Sm          
Gll         , Gll         , Rb          , Gll^Es      , Gll^Es      , Qxe         , Gll^Fp      , Gll^Fp      , Gll^Em      , Gll^Fp      , Gll         , Gll         , Gll^Fp      , Gll^Fp      , Gll^Fp      , Gll^Fp      , Gll^Fp      , Gll         , Gll^Fp      , Gll         , Gll         , Gd          , Gll^Fp      , Gd          , Gd^Fmw      , Gd^Fmw      , Gll         , Gll         , Gd^Fetd     , Re          , Rb          , Re          , Ce          , Ce          , Ce          , Ce          , Re^Vct      , Ww          
Rb          , Rb          , Gll^Fp      , Gll^Fp      , Hh^Fp       , Qxe         , Qxe         , Gll^Fp      , Gll^Fp      , Gll^Fp      , Gg^Efm      , Gll^Fp      , Gll         , Gll^Fp      , Gg^Fet      , Gll^Fp      , Gll^Fp      , Gll         , Gll^Em      , Gll^Fp      , Gll^Fp      , Gll^Em      , Gll^Fp      , Gll^Em      , Gd^Fmw      , Gs^Fdw      , Gs          , Gll         , Gll         , Re          , Rb          , Re          , Sm          , Re^Vct      , Re^Vct      , 2 Ke        , Rb          , Sm          
Gll^Fp      , Gll^Fp      , Gll^Fp      , Gll^Fp      , Gll^Fp      , Hh^Fp       , Qxe         , Hh^Fp       , Gll^Fp      , Gd^Vhr      , Gll^Fp      , Gll^Fp      , Gll^Fp      , Gll^Em      , Gll^Fp      , Gll^Fp      , Gll^Fp      , Gll^Em      , Gll^Fp      , Gll^Fp      , Gll^Fp      , Gll^Fp      , Gll^Fp      , Gll^Fp      , Gd^Fmw      , Gll^Em      , Gd^Fmw      , Gd^Fmw      , Gs^Fdw      , Gll         , Gll         , Rb          , Re          , Ww          , Sm          , Rb          , Ur          , Rb          
Gll^Fp      , Gll^Fp      , Gll^Fp      , Gll^Fp      , Gll^Fp      , Gll^Fp      , Gll^Fp      , Qxe         , Qxe         , Gll^Fp      , Gll^Fp      , Gll^Fp      , Gll^Fp      , Gll^Fp      , Gll^Fp      , Gll^Fp      , Gll^Fp      , Gll^Fp      , Gll^Fp      , Gll^Fp      , Gll^Fp      , Gll^Fp      , Gll^Fp      , Gll^Fp      , Gll^Fp      , Gd^Fmw      , Gll^Fp      , Gd^Fmw      , Gll^Fp      , Gd^Fmw      , Gd^Fmw      , Rb          , Rb          , Re          , Rb          , Rb          , Rb          , Rb          
