border_size=1
usage=map

Mm^Xm       , Mm^Xm       , Mm^Xm       , Mm^Xm       , Mm^Xm       , Mm^Xm       , Mm^Xm       , Mm^Xm       , Mm^Xm       , Mm          , Mm^Xm       , Mm^Xm       , Mm^Xm       , Mm^Xm       , Mm^Xm       , Mm^Xm       , Mm^Xm       , Mm^Xm       , Mm^Xm       , Mm^Xm       , Mm^Xm       , Mm^Xm       , Mm^Xm       , Mm^Xm       , Mm^Xm       , Mm^Xm       , Mm^Xm       , Mm^Xm       , Mm^Xm       , Mm^Xm       , Mm^Xm       , Mm^Xm       , Mm^Xm       , Mm^Xm       , Mm^Xm       , Mm^Xm       , Mm^Xm       , Mm^Xm       , Mm^Xm       , Mm^Xm       , Mm^Xm       , Mm          , Mm^Xm       , Mm^Xm       , Mm^Xm       , Mm^Xm       , Mm^Xm       , Mm^Xm       , Mm^Xm       , Mm^Xm       , Mm^Xm       , Mm^Xm       , Mm^Xm       , Mm^Xm       , Mm^Xm       , Mm^Xm       , Mm^Xm       , Mm^Xm       , Mm^Xm       , Mm^Xm       , Mm^Xm       , Mm          
Mm^Xm       , Mm^Xm       , Mm^Xm       , Mm^Xm       , Mm^Xm       , Mm^Xm       , Mm^Xm       , Mm^Xm       , Mm          , Mm^Xm       , Mm^Xm       , Mm^Xm       , Mm          , Mm^Xm       , Mm          , Mm^Xm       , Mm          , Mm^Xm       , Mm          , Mm^Xm       , Mm          , Mm^Xm       , Mm          , Mm          , Mm          , Mm          , Mm          , Mm          , Mm          , Mm          , Mm          , Mm          , Mm          , Mm^Xm       , Mm          , Mm^Xm       , Mm          , Mm^Xm       , Mm          , Mm^Xm       , Mm          , Mm^Xm       , Mm          , Mm^Xm       , Mm          , Mm^Xm       , Mm          , Mm^Xm       , Ww          , Mm^Xm       , Mm          , Mm          , Mm          , Mm^Xm       , Mm          , Mm^Xm       , Mm^Xm       , Mm^Xm       , Mm^Xm       , Mm^Xm       , Mm^Xm       , Mm^Xm       
Mm^Xm       , Mm^Xm       , Mm^Xm       , Mm^Xm       , Mm^Xm       , Mm^Xm       , Mm^Xm       , Mm^Xm       , Mm^Xm       , Mm^Xm       , Mm^Xm       , Mm          , Mm          , Mm          , Ww          , Mm          , Mm          , Mm          , Mm          , Mm          , Mm          , Mm          , Hh^Fp       , Mm          , Hh^Fp       , Mm          , Hh^Fp       , Mm          , Mm          , Mm          , Mm          , Mm          , Mm          , Mm          , Mm          , Mm          , Mm          , Mm          , Mm          , Mm          , Mm          , Mm          , Mm          , Mm          , Mm          , Mm          , Mm          , Mm          , Mm          , Ww          , Mm          , Mm          , Mm          , Mm          , Mm          , Mm          , Mm          , Mm^Xm       , Mm^Xm       , Mm^Xm       , Mm^Xm       , Mm^Xm       
Mm^Xm       , Mm^Xm       , Mm^Xm       , Mm^Xm       , Mm^Xm       , Mm^Xm       , Mm^Xm       , Mm          , Mm^Xm       , Ww          , Ww          , Ww          , Ww          , Ww          , Mm          , Ww          , Mm          , Mm          , Mm          , Mm          , Mm          , Hhd^Vhhr    , Hh^Fp       , Hh^Fp       , Hh^Fp       , Hh^Fp       , Hh^Fp       , Hh^Fp       , Hh^Fp       , Mm          , Gll^Fp      , Hh^Fp       , Hh^Fp       , Mm          , Gll^Fp      , Mm          , Hh^Fp       , Hh^Fp       , Hh^Fp       , Hh^Fp       , Hh^Fp       , Mm          , Mm          , Mm          , Mm          , Mm          , Mm          , Mm          , Ww          , Ww          , Mm          , Mm          , Mm          , Mm          , Mm          , Mm          , Mm          , Mm          , Mm          , Mm^Xm       , Mm^Xm       , Mm^Xm       
Mm^Xm       , Mm^Xm       , Mm^Xm       , Mm^Xm       , Mm^Xm       , Mm^Xm       , Mm^Xm       , Mm^Xm       , Mm^Xm       , Mm          , Mm          , Mm          , Mm          , Mm          , Ww          , Wwr         , Mm          , Mm          , Mm          , Mm          , Mm          , Hh^Fp       , Hh^Fp       , Hh^Fp       , Hh^Fp       , Hh^Fp       , Hh^Fp       , Hh^Fp       , Gll^Fp      , Gd^Vo       , Gll^Fp      , Gll^Fp      , Gll^Es      , Gll^Fp      , Gll         , Gll^Fp      , Gll         , Gll         , Gll         , Hh^Fp       , Hh^Fp       , Hh^Fp       , Hh^Fp       , Hh^Fp       , Hh^Fp       , Mm          , Mm          , Ww          , Mm          , Mm          , Mm          , Mm          , Mm          , Mm          , Mm          , Mm          , Hhd^Vhhr    , Mm          , Mm          , Mm^Xm       , Mm^Xm       , Mm^Xm       
Mm^Xm       , Mm^Xm       , Mm^Xm       , Mm^Xm       , Mm^Xm       , Mm^Xm       , Mm^Xm       , Mm^Xm       , Mm^Xm       , Mm^Xm       , Mm          , Mm          , Mm          , Ww          , Mm          , Mm          , Mm          , Mm          , Mm          , Mm          , Hh^Fp       , Hh^Fp       , Hh^Fp       , Hh^Fp       , Hh^Fp       , Hh^Fp       , Gll^Fp      , Gll^Fp      , Gll         , Gll^Fp      , Gll         , Gll         , Gll         , Gll         , Gll         , Gll         , Gll         , Gll^Fp      , Gll^Fp      , Gll         , Gll         , Gd^Vo       , Gll         , Hh^Fp       , Gll         , Gll         , Gll         , Ww          , Ww          , Mm          , Mm          , Mm          , Hh^Vhh      , Mm          , Mm          , Mm          , Mm          , Mm          , Mm          , Mm^Xm       , Mm^Xm       , Mm          
Mm^Xm       , Mm^Xm       , Mm^Xm       , Mm^Xm       , Mm^Xm       , Mm^Xm       , Mm^Xm       , Mm^Xm       , Mm^Xm       , Mm          , Mm          , Mm          , Mm          , Ww          , Wwr         , Ww          , Ww          , Mm          , Mm          , Mm          , Hh^Fp       , Hh^Fp       , Hh^Fp       , Hh^Fp       , Mm          , Gll         , Gll         , Gll         , Gll^Fp      , Gll^Fp      , Gll         , Gll         , Gll         , Gll         , Ww          , Gll         , Gll^Fp      , Gll^Fp      , Gll^Fp      , Gll^Fp      , Gll^Fp      , Gll^Fp      , Gll         , Gll         , Gll         , Gll         , Gll^Fp      , Gll         , Ww          , Gll         , Re          , Re          , Re          , Mm          , Mm          , Mm          , Mm          , Mm          , Mm          , Mm^Xm       , Mm^Xm       , Mm          
Mm^Xm       , Mm^Xm       , Mm^Xm       , Mm^Xm       , Mm^Xm       , Mm^Xm       , Mm^Xm       , Mm^Xm       , Mm^Xm       , Mm          , Mm          , Mm          , Mm          , Mm          , Mm          , Mm          , Ww          , Mm          , Mm          , Mm          , Gll         , Mm          , Gll         , Gll         , Gll         , Gll         , Gll         , Gll^Fp      , Gll^Fp      , Gll         , Gll         , Gll         , Gll         , Gll         , Gll         , Gll         , Gll         , Gll^Fp      , Gll         , Gll^Fp      , Gll         , Gll         , Gll         , Gll^Fp      , Gd^Fetd     , Gll^Fp      , Gll^Fp      , Gll         , Ww          , Gll         , Gll         , Re          , Re          , Re          , Ce          , Ce          , Mm          , Mm          , Mm          , Ww          , Mm^Xm       , Mm          
Mm^Xm       , Mm^Xm       , Mm^Xm       , Mm^Xm       , Mm^Xm       , Mm^Xm       , Mm^Xm       , Mm^Xm       , Mm^Xm       , Mm          , Hh^Fp       , Mm          , Mm          , Mm          , Mm          , Mm          , Mm          , Ww          , Mm          , Mm          , Gll         , Gll         , Gll         , Gll         , Gll         , Gll^Efm     , Gll         , Gll         , Gll         , Gll         , Ww          , Ww          , Ww          , Ww          , Ww          , Gll         , Gll         , Gll         , Ww          , Gll         , Ww          , Gll         , Gll         , Gll         , Gll         , Gll^Fp      , Gll         , Ww          , Gll         , Gll         , Gll         , Re          , Re          , Re          , Ce          , 3 Ket       , Ww^Vm       , Ww          , Ww          , Ww          , Mm^Xm       , Mm          
Mm^Xm       , Mm^Xm       , Mm^Xm       , Mm^Xm       , Mm^Xm       , Mm^Xm       , Hh^Fp       , Hh^Fp       , Hh^Fp       , Hh^Fp       , Hh^Fp       , Hh^Fp       , Hh^Fp       , Mm          , Mm          , Mm          , Mm          , Ww          , Wwr         , Wwr         , Wwr         , Gll         , Gll         , Gll         , Gll         , Gll         , Ww^Ewl      , Gll         , Ww          , Ww          , Ww          , Ww          , Ww          , Ww          , Ww          , Ww          , Ww          , Ww          , Ww          , Ww          , Ww          , Ww          , Ww          , Gll         , Ww          , Gll         , Ww^Ewf      , Ww^Ewl      , Re          , Re          , Re          , Re          , Re          , Re          , Mm          , Ce          , Ww          , Ce          , Mm          , Mm          , Mm^Xm       , Mm          
Mm^Xm       , Mm^Xm       , Mm^Xm       , Mm^Xm       , Mm^Xm       , Mm^Xm       , Hh^Fp       , Hh^Fp       , Mm          , Hh^Fp       , Hh^Fp       , Hh^Fp       , Mm          , Mm          , Mm          , Mm          , Mm          , Mm          , Gll         , Gll         , Ww          , Gll         , Ww^Ewl      , Ww^Ewf      , Ww^Ewl      , Ww^Ewf      , Gll         , Gll         , Ww          , Ww          , Ww          , Ww          , Ww          , Ww          , Ww          , Ww          , Ww          , Ww          , Ww          , Ww          , Ww          , Ww          , Ww          , Ww          , Ww          , Gll         , Ww^Vm       , Ww^Ewl      , Re          , Gll^Efm     , Gll         , Re          , Re          , Re          , Mm          , Ww          , Mm          , Mm          , Mm^Xm       , Mm^Xm       , Mm^Xm       , Mm          
Mm^Xm       , Mm^Xm       , Mm^Xm       , Mm^Xm       , Mm^Xm       , Mm^Xm       , Hh^Fp       , Mm          , Hh^Fp       , Hh^Fp       , Hh^Fp       , Hh^Fp       , Mm          , Hh^Fp       , Mm          , Mm          , Gll         , Gll         , Gll         , Gll         , Ww          , Gll         , Gll         , Gll         , Ww^Ewf      , Gll         , Gll         , Gll         , Ww          , Ww          , Ww          , Ww          , Wo          , Ww          , Wo          , Ww          , Wo          , Wo          , Wo          , Ww          , Ww          , Ww          , Ww          , Ww          , Ww          , Ww          , Ww          , Gll         , Gll         , Gll         , Gll         , Gll         , Re          , Mm          , Wwr         , Wwr         , Mm          , Mm          , Mm          , Mm^Xm       , Mm          , Mm          
Mm^Xm       , Mm^Xm       , Mm^Xm       , Mm^Xm       , Hh^Fp       , Hh^Fp       , Mm          , Hh^Fp       , Hh^Fp       , Hh^Fp       , Hh^Fp       , Hh^Fp       , Gll^Fp      , Hh^Fp       , Gll         , Gll         , Gll         , Gll         , Gll         , Gll         , Ww          , Gll         , Ww          , Gll         , Ww          , Ww          , Ww          , Ww          , Ww          , Ww          , Ww          , Wo          , Wo          , Wo          , Wo          , Wo          , Wo          , Ww          , Ww          , Wo          , Wo          , Wo          , Wo          , Ww          , Ww          , Ww          , Ww          , Gll         , Gll         , Gll         , Ww          , Ww          , Ww          , Wwr         , Wwr         , Mm          , Mm          , Mm          , Mm          , Mm^Xm       , Mm^Xm       , Mm          
Mm^Xm       , Mm^Xm       , Mm^Xm       , Hh^Fp       , Mm          , Mm          , Mm          , Hh^Fp       , Hh^Fp       , Hh^Fp       , Hh^Fp       , Gll^Fp      , Gll^Fp      , Gd^Vo       , Gll         , Gll         , Gll         , Gll         , Ww          , Gll         , Ww          , Ww          , Ww          , Ww          , Ww          , Ww          , Ww          , Ww          , Ww          , Ww          , Ww          , Ww          , Ww          , Wo          , Ww          , Wo          , Wo          , Wo          , Wo          , Wo          , Wo          , Wo          , Ww          , Ww          , Ww          , Ww          , Ww          , Ww          , Ww          , Ww          , Gll         , Gll         , Gll         , Gd^Vo       , Mm          , Mm          , Mm          , Mm^Xm       , Mm^Xm       , Mm          , Mm^Xm       , Mm          
Mm^Xm       , Mm^Xm       , Mm          , Mm          , Mm          , Mm          , Mm          , Hh^Fp       , Hh^Fp       , Hh^Fp       , Gll^Fp      , Gll^Fp      , Gll^Fp      , Gll         , Gll         , Gll         , Gll         , Ww          , Ww          , Ww          , Ww          , Ww          , Ww          , Ww          , Ww          , Ww          , Ww          , Ww          , Ww          , Ww          , Mm          , Ww          , Ww          , Ww          , Ww          , Ww          , Ww          , Wo          , Wo          , Wo          , Wo          , Wo          , Wo          , Wo          , Wo          , Ww          , Ww          , Ww          , Ww          , Gll         , Gll         , Gll         , Gll^Efm     , Gll         , Mm          , Mm          , Mm          , Mm^Xm       , Mm^Xm       , Mm          , Mm          , Mm^Xm       
Mm^Xm       , Mm^Xm       , Mm^Xm       , Mm          , Mm          , Mm          , Mm          , Hh^Fp       , Hh^Fp       , Hh^Fp       , Gll^Fp      , Gll^Fp      , Gll^Fp      , Gll^Fp      , Gll         , Gll         , Ww          , Ww          , Ww          , Ww          , Ww          , Ww          , Ww          , Ww          , Mm          , Ww^Vm       , Co          , Mm          , Mm          , Hh          , Hh          , Mm          , Mm          , Ww          , Mm          , Ww          , Ww          , Ww          , Ww          , Wo          , Wo          , Wo          , Wo          , Wo          , Wo          , Wo          , Wo          , Ww          , Ww          , Ww          , Gll         , Gll         , Gll^Es      , Gll         , Rb          , Rb          , Rb          , Mm          , Mm          , Mm^Xm       , Mm^Xm       , Mm^Xm       
Mm^Xm       , Mm^Xm       , Mm          , Mm          , Mm          , Mm          , Hh^Fp       , Hh^Fp       , Hh^Fp       , Hh^Fp       , Gll^Fp      , Gll^Fp      , Gll^Efm     , Gll         , Gll         , Ww          , Ww          , Ww          , Ww          , Wo          , Wo          , Wo          , Wo          , Mm          , Mm          , Co          , 2 Ko        , Co          , Mm          , Hhd^Vhhr    , Wwr         , Gd^Fetd     , Mm          , Mm          , Mm          , Ww          , Ww          , Ww          , Ww          , Wo          , Wo          , Wo          , Wo          , Wo          , Wo          , Wo          , Ww          , Wo          , Ww          , Ww          , Gll         , Gll         , Gll         , Gll         , Mm^Xm       , Rb          , Mm^Xm       , Rb          , Rb          , Mm^Xm       , Rb          , Mm^Xm       
Mm^Xm       , Mm^Xm       , Mm^Xm       , Mm^Xm       , Mm          , Mm          , Hh^Fp       , Hh^Fp       , Gll^Fp      , Gll^Fp      , Gll^Fp      , Gll^Fp      , Gll         , Gll         , Ww          , Ww          , Ww          , Ww          , Wo          , Wo          , Ww          , Ww          , Wwr         , Mm          , Mm          , Co          , Mm          , Mm          , Mm          , Hh          , Hh          , Hh          , Wwr         , Wwr         , Wwr         , Ww          , Ww          , Ww          , Ww          , Ww          , Ww          , Wo          , Ww          , Wo          , Ww          , Wo          , Ww          , Ww          , Ww          , Ww          , Mm^Xm       , Mm^Xm       , Mm^Xm       , Mm^Xm       , Wo          , Mm^Xm       , Mm^Xm       , Mm^Xm       , Mm^Xm       , Rb          , Mm^Xm       , Rb          
Mm^Xm       , Mm^Xm       , Mm^Xm       , Mm^Xm       , Mm          , Mm          , Mm          , Hh^Fp       , Hh^Fp       , Gll^Fp      , Gd^Vo       , Gll         , Gll         , Gll         , Ww^Vm       , Ww          , Wo          , Wo          , Ww          , Wo          , Ww          , Ww^Vm       , Wwr         , Mm          , Ww          , Ww          , Ww          , Ww          , Ww          , Mm          , Ww          , Mm          , Ww          , Ww          , Wo          , Wo          , Wo          , Ww          , Wo          , Ww          , Wo          , Wo          , Wo          , Ww          , Wo          , Wo          , Wo          , Wo          , Wo          , Ww          , Mm^Xm       , Mm^Xm       , Wo          , Wo          , Wo          , Wo          , Wo          , Wo          , Wo          , Mm^Xm       , Mm^Xm       , Rb          
Mm^Xm       , Mm^Xm       , Mm^Xm       , Mm^Xm       , Mm          , Mm          , Hh^Fp       , Hh^Fp       , Gll^Fp      , Gll^Fp      , Gll^Fp      , Gll         , Gll         , Gll         , Gll         , Ww          , Wo          , Wo          , Wo          , Ww          , Ww          , Wwr         , Ww          , Ww          , Ww          , Ww          , Ww          , Ww          , Ww          , Ww          , Ww          , Ww          , Ww          , Wo          , Ww          , Ww          , Ww          , Wo          , Ww          , Wo          , Ww          , Ww          , Ww          , Wo          , Ww          , Wo          , Wo          , Wo          , Wo          , Ww          , Wo          , Wo          , Wo          , Wo          , Wwr         , Wo          , Wo          , Wo          , Wwr         , Wo          , Wo          , Mm^Xm       
Mm^Xm       , Mm^Xm       , Mm^Xm       , Mm^Xm       , Mm          , Hhd^Vhhr    , Mm          , Hh^Fp       , Gll^Fp      , Gll^Fp      , Gll^Fp      , Gll^Fp      , Gll         , Gll         , Gll         , Ww          , Wo          , Wo          , Wo          , Ww          , Ww          , Ww          , Wo          , Wo          , Wo          , Ww          , Ww          , Ww          , Wo          , Ww          , Ww          , Ww          , Ww          , Ww          , Ww          , Ww          , Ww          , Ww          , Ww          , Ww          , Ww          , Ww          , Ww          , Ww          , Ww          , Ww          , Ww          , Wo          , Wo          , Wo          , Wo          , Wo          , Wo          , Wo          , Wo          , Wwr         , Wo          , Wwr         , Md^Xm       , Wo          , Wo          , Wo          
Mm^Xm       , Mm^Xm       , Mm^Xm       , Mm          , Mm          , Mm          , Mm          , Mm          , Mm          , Gll^Fp      , Gll^Fp      , Gll^Fp      , Gll^Fp      , Gll         , Gll         , Ww          , Wo          , Wo          , Wo          , Ww          , Wo          , Ww          , Wo          , Wo          , Ww          , Wo          , Wo          , Wo          , Ww          , Ww          , Ww          , Ww          , Ww          , Ww          , Ww          , Ww          , Ww          , Ww          , Ww          , Ww          , Ww          , Ww          , Ww          , Ww          , Wo          , Wo          , Wo          , Wo          , Wo          , Ww          , Mm^Xm       , Mm^Xm       , Mm^Xm       , Mm^Xm       , Mm^Xm       , Wo          , Wo          , Wwr         , Md^Xm       , Md          , Md          , Md          
Mm^Xm       , Mm^Xm       , Mm          , Mm          , Mm          , Mm          , Mm          , Mm          , Mm          , Mm          , Mm          , Gll^Fp      , Mm          , Gll         , Wo          , Wo          , Wo          , Wo          , Ww          , Wo          , Ww          , Wo          , Ww          , Ww          , Ww          , Ww          , Ww          , Wo          , Wo          , Ww          , Ww          , Ww          , Ww          , Ww          , Gll         , Gll         , Gll         , Ww          , Gll         , Ww          , Ww          , Ww          , Ww          , Ww          , Ww          , Wo          , Ww          , Wo          , Wo          , Mm^Xm       , Hhd^Fmf     , Mm^Xm       , Hhd^Fmf     , Mm^Xm       , Mm^Xm       , Mm^Xm       , Wo          , Wo          , Wo          , Md          , Md          , Md          
Mm^Xm       , Mm          , Mm          , Mm          , Mm^Xm       , Mm          , Mm          , Mm          , Mm          , Mm          , Mm          , Mm          , Mm^Xm       , Ww^Vm       , Wo          , Wo          , Ww          , Ww          , Ww          , Ww          , Ww          , Ww          , Ww          , Ww          , Wo          , Wo          , Wo          , Wo          , Ww          , Ww          , Ww          , Ww          , Ww          , Ww          , Gll         , Gll         , Gll         , Gll         , Gll         , Gll         , Gll         , Gll         , Gll         , Ww          , Gll         , Ww          , Ww          , Ww          , Ww          , Gll         , Gll         , Hhd^Fmf     , Hhd^Fmf     , Hhd^Fmf     , Hhd^Fmf     , Mm^Xm       , Mm^Xm       , Wo          , Wo          , Wo          , Wo          , Md          
Mm^Xm       , Mm^Xm       , Mm          , Mm          , Mm          , Mm^Xm       , Mm          , Mm          , Mm^Xm       , Mm^Xm       , Mm          , Mm^Xm       , Wo          , Wo          , Wo          , Wo          , Wo          , Wo          , Wo          , Wo          , Wo          , Ww          , Wo          , Wo          , Ww          , Ww          , Ww          , Ww          , Ww          , Ww          , Ww          , Ww          , Ww          , Ww          , Gll         , Gll         , Gll         , Gll         , Gll         , Gll         , Gll         , Gll         , Gll         , Gll         , Gll         , Gll         , Gll         , Gll         , Gll         , Ww          , Ww          , Gg^Ve       , Gll^Fmf     , Gg^Fet      , Hhd^Fmf     , Mm          , Mm^Xm       , Wo          , Wo          , Wo          , Wo          , Wo          
Mm          , Mm          , Mm^Xm       , Mm          , Mm          , Mm          , Mm^Xm       , Mm          , Mm^Xm       , Mm^Xm       , Wo          , Wo          , Wo          , Wo          , Wo          , Wo          , Ww          , Ww          , Ww          , Ww          , Gll         , Ww          , Ww          , Ww          , Ww          , Ww          , Ww          , Ww          , Gll         , Ww          , Gll         , Ww          , Gll         , Gll         , Gll         , Gll         , Gll^Fmf     , Gll^Fmf     , Gll^Fmf     , Gll         , Gll^Fmf     , Gll         , Gll^Fmf     , Gll         , Gll         , Gll         , Gll         , Gll         , Gll         , Gll^Es      , Wwr         , Gll^Fmf     , Hhd^Fmf     , Hhd^Fmf     , Mm          , Mm^Xm       , Mm          , Mm^Xm       , Mm^Xm       , Wo          , Mm^Xm       , Wo          
Mm^Xm       , Mm^Xm       , Mm^Xm       , Mm          , Mm          , Mm          , Mm          , Mm^Xm       , Mm          , Wo          , Wo          , Wo          , Wo          , Wo          , Re          , Wo          , Ww          , Ww          , Ww          , Gll         , Gll^Efm     , Gll         , Gll         , Ww          , Gll         , Ww          , Gll         , Ww          , Ww          , Ww          , Gll         , Gll         , Gll         , Gll         , Gll^Fmf     , Gll         , Gg^Ve       , Gll^Fmf     , Gll^Fmf     , Gll^Fmf     , Gll^Fmf     , Gll^Fmf     , Gll^Fmf     , Gll^Fmf     , Gll^Fmf     , Gll         , Hhd^Fmf     , Gll         , Gll^Fmf     , Wwr         , Gll^Fmf     , Hhd^Fmf     , Mm          , Mm          , Mm          , Mm^Xm       , Mm^Xm       , Mm          , Mm          , Mm^Xm       , Mm^Xm       , Mm^Xm       
Mm^Xm       , Mm^Xm       , Mm^Xm       , Mm          , Mm          , Mm          , Mm          , Mm^Xm       , Mm^Xm       , Wo          , Wo          , Wo          , Wo          , Wo          , Re          , Gll         , 1 Re        , Gll         , Gll         , Gll         , Gll         , Gll         , Gll         , Gll         , Gll         , Gll         , Ww          , Ww          , Gll         , Gll         , Gll         , Gll         , Gll         , Gll         , Gll^Fmf     , Gll^Fmf     , Gll^Fmf     , Gll^Fmf     , Hhd^Fmf     , Gll^Fmf     , Hhd^Fmf     , Gll^Fmf     , Gll^Fmf     , Gll^Fmf     , Gll^Fmf     , Gll^Fmf     , Gll^Fmf     , Gll^Fmf     , Gll^Fmf     , Ww          , Ww          , Ww          , Ww          , Mm          , Mm          , Mm          , Mm          , Mm^Xm       , Mm^Xm       , Mm^Xm       , Mm^Xm       , Mm^Xm       
Mm^Xm       , Mm^Xm       , Mm          , Mm          , Mm          , Mm          , Mm          , Mm^Xm       , Mm^Xm       , Wo          , Wo          , Wo          , Re          , Ww          , Ww          , Re          , Re          , Gll         , Gll^Fmf     , Gll         , Gll^Fmf     , Gll         , Gll^Fmf     , Gll^Fmf     , Gll^Fmf     , Gll         , Ww          , Gll         , Gll         , Gll         , Mm          , Gll         , Mm          , Gll^Fmf     , Gll^Fmf     , Gll^Fmf     , Mm          , Gll^Fmf     , Hhd^Fmf     , Gg^Fet      , Hhd^Fmf     , Hhd^Fmf     , Gll^Fmf     , Gll^Fmf     , Gll^Fmf     , Gll^Fmf     , Gll^Fmf     , Gll^Fmf     , Mm          , Hhd^Fmf     , Mm          , Mm          , Mm          , Ww          , Ww          , Mm          , Mm          , Mm          , Mm          , Mm          , Mm^Xm       , Mm^Xm       
Mm^Xm       , Mm^Xm       , Mm^Xm       , Mm          , Mm^Xm       , Mm^Xm       , Mm^Xm       , Mm^Xm       , Mm^Xm       , Wo          , Wo          , Wo          , Wo          , Ww          , Hh          , Re          , Gll^Fmf     , Gll^Fmf     , Gll^Fmf     , Gll^Fmf     , Gll^Fmf     , Gll^Fmf     , Hh^Fms      , Gll^Fmf     , Gs^Vl       , Gll         , Mm          , Ww          , Mm          , Mm          , Mm          , Mm          , Mm          , Mm          , Mm          , Gll^Fmf     , Gll^Fmf     , Gll^Fmf     , Hhd^Fmf     , Hhd^Fmf     , Hhd^Fmf     , Hhd^Fmf     , Hhd^Fmf     , Gs^Vl       , Hhd^Fmf     , Hhd^Fmf     , Mm          , Mm          , Mm          , Mm          , Mm          , Mm          , Mm          , Mm          , Ww          , Mm          , Mm          , Mm          , Mm^Xm       , Mm          , Mm^Xm       , Mm^Xm       
Mm^Xm       , Mm^Xm       , Mm^Xm       , Mm^Xm       , Mm^Xm       , Mm^Xm       , Mm^Xm       , Mm^Xm       , Wo          , Wo          , Wo          , Wo          , Mm^Xm       , Mm^Xm       , Mm^Xm       , Gll^Fmf     , Mm          , Gll^Fmf     , Gll^Fmf     , Hh^Fms      , Hh^Fms      , Hh^Fms      , Gll^Fmf     , Gll^Fmf     , Mm          , Mm          , Mm          , Ww          , Mm          , Mm          , Mm^Xm       , Mm^Xm       , Mm^Xm       , Mm          , Mm^Xm       , Mm          , Mm          , Mm          , Mm          , Mm          , Mm          , Mm          , Mm          , Mm          , Mm          , Mm          , Mm          , Mm          , Mm          , Mm          , Mm          , Mm          , Mm          , Mm          , Mm          , Ww          , Ww          , Mm          , Mm          , Mm^Xm       , Mm^Xm       , Mm          
Mm          , Mm^Xm       , Mm^Xm       , Mm^Xm       , Mm^Xm       , Mm^Xm       , Wo          , Wo          , Wo          , Wo          , Mm^Xm       , Mm^Xm       , Mm^Xm       , Mm^Xm       , Mm^Xm       , Mm^Xm       , Mm^Xm       , Mm^Xm       , Mm^Xm       , Mm^Xm       , Mm^Xm       , Mm^Xm       , Mm^Xm       , Mm^Xm       , Mm^Xm       , Mm^Xm       , Mm^Xm       , Mm^Xm       , Mm^Xm       , Mm^Xm       , Mm^Xm       , Mm^Xm       , Mm^Xm       , Mm^Xm       , Mm^Xm       , Mm^Xm       , Mm^Xm       , Mm^Xm       , Mm^Xm       , Mm^Xm       , Mm^Xm       , Mm^Xm       , Mm^Xm       , Mm^Xm       , Mm^Xm       , Mm^Xm       , Mm^Xm       , Mm^Xm       , Mm^Xm       , Mm^Xm       , Mm^Xm       , Mm^Xm       , Mm^Xm       , Mm^Xm       , Mm^Xm       , Mm^Xm       , Mm^Xm       , Mm^Xm       , Mm^Xm       , Mm^Xm       , Mm^Xm       , Mm          
