border_size=1
usage=map

Gs^Fds      , Gs^Fds      , Gs^Fds      , Gll         , Gs^Fds      , Gll         , Gs^Fds      , Gll         , Gs^Fds      , Gll         , Gs^Fds      , Gs^Fds      , Gs^Fds      , Gs^Fds      , Gs^Fds      , Gs^Fds      , Hh^Fds      , Hh^Fds      , Hh^Fds      , Hh^Fds      , Hh^Fds      , Hh^Fds      , Hh^Fds      , Hh^Fds      , Hh^Fds      , Hh^Fds      , Hh^Fds      , Hh^Fds      , Gll         , Ww          , Gs^Fms      , Gll         , Gs^Fms      , Hh^Fms      , Hh^Fms      , Hh^Fms      , Hh^Fms      , Hh^Fms      , Hh^Fms      
Gs^Fds      , Gs^Fds      , Gs^Fds      , Gs^Fds      , Gs^Fds      , Gs^Fds      , Gs^Fds      , 1 Gs^Fds    , Gs^Fds      , Gs^Fds      , Gs^Fds      , Gs^Fds      , Gs^Fds      , Gs^Fds      , Gll         , Gs^Fds      , Gll         , Gs^Fds      , Gs^Fds      , Gs^Fds      , Gll         , Hh^Fds      , Hh^Fds      , Hh^Fds      , Hh^Fds      , Hh^Fds      , Gs^Fds      , Gs^Fds      , Ww          , Ww          , Gll         , Gll         , Gs^Fms      , Gs^Fms      , Gs^Fms      , Hh^Fms      , Hh^Fms      , Hh^Fms      , Hh^Fms      
Gll         , Gs^Fds      , Gs^Fds      , Gs^Fds      , Gs^Fds      , Gs^Fds      , Gs^Fds      , Gs^Fds      , Gll         , Gs^Fds      , Gs^Fds      , Gs^Fds      , Gs^Fds      , Gll         , Gll         , Gs^Fds      , Gll         , Gs^Fds      , Gs^Fds      , Gs^Fds      , Gs^Fds      , Gs^Fds      , Gs^Fds      , Gll         , Gs^Fds      , Gll         , Gll         , Gll         , Ww          , Gll         , Gll         , Gll         , Gll         , Gs^Fms      , Gll         , Hh^Fms      , Hh^Fms      , Hh^Fms      , Hh^Fms      
Gs^Fds      , Gs^Fds      , Gs^Fds      , Gs^Fds      , Gs^Fds      , Gs^Fds      , Gll         , Gg^Ve       , Gs^Fds      , Gs^Fds      , Gll         , Gs^Fds      , Gs^Fds      , Gll         , Gs^Fds      , Gs^Fds      , Gs^Fds      , Gs^Fds      , Gs^Fds      , Gll         , Gs^Fds      , Gs^Fds      , Gs^Fds      , Gll         , Gs^Fds      , Gll         , Gs^Fds      , Gll         , Ww          , Gs^Fms      , Gll         , Gs^Fms      , Gs^Fms      , Gll         , Gs^Fms      , Gs^Fms      , Gs^Fms      , Hh^Fms      , Hh^Fms      
Gs^Fds      , Gs^Fds      , Gs^Fds      , Gs^Fds      , Gs^Fds      , Gll         , Gs^Fds      , Gs^Fds      , Gs^Fds      , Gs^Fds      , Gs^Fds      , Gs^Fds      , Gs^Fds      , Gs^Fds      , Gs^Fds      , Gs^Fds      , Gg^Ve       , Gs^Fds      , Gs^Fds      , Gs^Fds      , Gs^Fds      , Gs^Fds      , Gs^Fds      , Gs^Fds      , Gs^Fds      , Gs^Fds      , Ww          , Ww          , Gs^Fms      , Gs^Fms      , Gs^Fms      , Gs^Fms      , Gll         , Gs^Fms      , Gs^Fms      , Gs^Fms      , Hh^Fms      , Hh^Fms      , Hh^Fms      
Gs^Fds      , Gs^Fds      , Gs^Fds      , Gs^Fds      , Gs^Fds      , Gs^Fds      , Gll         , Gs^Fds      , Gs^Fds      , Gs^Fds      , Gs^Fds      , Gs^Fds      , Gs^Fds      , Gs^Fds      , Gs^Fds      , Gs^Fds      , Gs^Fds      , Gs^Fds      , Gs^Fds      , Gs^Fds      , Gs^Fds      , Gs^Fds      , Gs^Fds      , Gs^Fds      , Gs^Fds      , Gs^Fds      , Ww          , Gs^Fms      , Gs^Fms      , Gs^Fms      , Gs^Fms      , Gll         , Gll         , Gs^Fms      , Gs^Fms      , Hh^Fms      , Hh^Fms      , Hh^Fms      , Hh^Fms      
Ww          , Gs^Fds      , Ww          , Gs^Fds      , Gs^Fds      , Gs^Fds      , Gs^Fds      , Gll         , Gll         , Gs^Fds      , Gll         , Gs^Fds      , Gs^Fds      , Gs^Fds      , Gs^Fds      , Gs^Fds      , Gll         , Gll         , Gll         , Gs^Fds      , Gll         , Gs^Fds      , Gll         , Gs^Fds      , Gs^Fds      , Gll         , Gs^Fds      , Ww          , Gll         , Gs^Fms      , Gs^Fms      , Gg^Ve       , Gs^Fms      , Gs^Fms      , Gs^Fms      , Gs^Fms      , Gs^Fms      , Gs^Fms      , Hh^Fms      
Gll         , Ww          , Ww          , Gll         , Gs^Fds      , Gs^Fds      , Ww          , Gs^Fds      , Gs^Fds      , Gs^Fds      , Gll         , Gs^Fds      , Gll         , Gs^Fds      , Gs^Fds      , Gs^Fds      , Gs^Fds      , Gs^Fds      , Gll         , Gs^Fds      , Gll         , Gs^Fds      , Gll         , Gs^Fds      , Ww          , Gll         , Ww          , Ww          , Gs^Fms      , Gs^Fms      , Gs^Fms      , Gs^Fms      , Gs^Fms      , Gs^Fms      , Gs^Fms      , Gs^Fms      , Gs^Fms      , 2 Hh^Fms    , Gs^Fms      
Gll^Fp      , Gll^Fp      , Gll         , Ww          , Ww          , Ww          , Ww          , Gll         , Gs^Fds      , Gll         , Gll         , Gll         , Gs^Fds      , Gs^Fds      , Gs^Fds      , Gs^Fds      , Gs^Fds      , Gll         , Ww          , Ww          , Ww          , Ww          , Ww          , Ww          , Ww          , Ww          , Gs^Fms      , Gs^Fms      , Gs^Fms      , Gll         , Gll         , Gs^Fms      , Gs^Fms      , Gs^Fms      , Gs^Fms      , Gs^Fms      , Gll         , Gs^Fms      , Gs^Fms      
Gll         , Gll         , Gll         , Gll^Fp      , Gll^Fp      , Gll^Fp      , Ww          , Ww          , Gs^Fds      , Gll         , Gll         , Gs^Fds      , Gll         , Gs^Fds      , Gll         , Gs^Fds      , Ww          , Ww          , Gs^Fms      , Ww          , Gs^Fms      , Gs^Fms      , Ww          , Gs^Fms      , Gs^Fms      , Gs^Fms      , Gs^Fms      , Gll         , Gs^Fms      , Gs^Fms      , Gs^Fms      , Gs^Fms      , Gs^Fms      , Gll         , Gs^Fms      , Gll         , Gs^Fms      , Gs^Fms      , Gs^Fms      
Gll^Fp      , Gll^Fp      , Gll^Fp      , Gll^Fp      , Gll^Fp      , Gll^Fp      , Ww          , Ww          , Ww          , Gs^Fds      , Ww          , Gll         , Gs^Fds      , Gs^Fds      , Ww          , Gs^Fds      , Ww          , Ww          , Gs^Fms      , Gs^Fms      , Ww^Ewl      , Gs^Fms      , Ww^Ewf      , Gs^Fms      , Gs^Fms      , Gs^Fms      , Gs^Fms      , Gll         , Gs^Fms      , Gs^Fms      , Gs^Fms      , Gs^Fms      , Gs^Fms      , Gs^Fms      , Gll         , Gll         , Gll         , Gs^Fms      , Gs^Fms      
Gll         , Gll^Fp      , Gd^Vo       , Gll^Fp      , Ww          , Ww          , Gll         , Gll^Fp      , Gll         , Ww          , Gll^Fp      , Ww          , Ww          , Ww          , Ww          , Ww          , Gll         , Ww          , Ww^Ewf      , Ww^Ewf      , Gll         , Ww^Ewl      , Gs^Fms      , Gs^Fms      , Gs^Fms      , Gs^Fms      , Gll         , Gs^Fms      , Gs^Fms      , Gs^Fms      , Gs^Fms      , Gs^Fms      , Gs^Fms      , Gs^Fms      , Gs^Fms      , Gs^Fms      , Gs^Fms      , Gs^Fms      , Gs^Fms      
Gll         , Gll^Fp      , Gll^Fp      , Gll^Fp      , Ww          , Gll^Fp      , Gll^Fp      , Gll^Fp      , Gll^Fp      , Gll^Fp      , Gll^Fp      , Ww          , Gs^Fms      , Ww          , Gs^Fms      , Gs^Fms      , Gs^Fms      , Gs^Fms      , Gs^Fms      , Gll         , Gs^Fms      , Gs^Fms      , Gs^Fms      , Gg^Ve       , Gll         , Gs^Fms      , Gs^Fms      , Gs^Fms      , Gll         , Gll         , Gll         , Gll         , Gs^Fms      , Gs^Fms      , Gll         , Gll         , Gs^Fms      , Gll         , Gll         
Gll^Fp      , Gll^Fp      , Gll^Fp      , Gll^Fp      , Gll^Fp      , Ww          , Ww          , Gll         , Ww          , Gll         , Ww          , Ww          , Gs^Fms      , Gs^Fms      , Gll         , Gll         , Gll         , Gs^Fms      , Gs^Fms      , Gll         , Gs^Fms      , Gs^Fms      , Gs^Fms      , Gs^Fms      , Gs^Fms      , Gll         , Gll         , Gll         , Gs^Fms      , Gs^Fms      , Gll         , Gs^Fms      , Gs^Fms      , Gll         , Gll         , Gll         , Gs^Fms      , Gs^Fms      , Gll         
Gll^Fp      , Gll^Fp      , Gll^Fp      , Gll^Fp      , Gll^Fp      , Ww          , Gs^Fms      , Ww          , Gs^Fms      , Ww          , Gs^Fms      , Gs^Fms      , Gll         , Gs^Fms      , Gs^Fms      , Gs^Fms      , Gll         , Gll         , Gs^Fms      , Gs^Fms      , Gs^Fms      , Gs^Fms      , Gs^Fms      , Gs^Fms      , Gs^Fms      , Gs^Fms      , Gll         , Gll         , Gll         , Gs^Fms      , Gll         , Gs^Fms      , Gll         , Gll         , Gs^Fms      , Gs^Fms      , Gs^Fms      , Gs^Fms      , Gs^Fms      
Gll^Fp      , Gll^Fp      , Ww          , Gll^Fp      , Ww          , Ww          , Gs^Fms      , Gd          , Gd          , Gs^Fms      , Gd          , Gs^Fms      , Gs^Fms      , Gs^Fms      , Gs^Fms      , Gs^Fms      , Gs^Fms      , Gs^Fms      , Gll         , Gs^Fms      , Gll         , Gll         , Gs^Fms      , Gs^Fms      , Gs^Fms      , Gs^Fms      , Gs^Fms      , Gs^Fms      , Gs^Fms      , Gs^Fms      , Gs^Fms      , Gll         , Gs^Fms      , Gs^Fms      , Gs^Fms      , Gll         , Gs^Fms      , Gll         , Gs^Fms      
Ww          , Ww          , Gs^Fms      , Ww          , Gs^Fms      , Gd          , Gd          , Gd          , Gd          , Gd          , Gs^Vl       , Gs^Fms      , Gs^Fms      , Gs^Fms      , Gs^Fms      , Gs^Fms      , Hh^Fms      , Gs^Fms      , Gs^Fms      , Gs^Fms      , Gll         , Gs^Fms      , Gs^Fms      , Gs^Fms      , Gs^Fms      , Gs^Fms      , Gll         , Gll         , Gll         , Gs^Fms      , Gs^Fms      , Gs^Fms      , Gs^Fms      , Gs^Fms      , Gg^Ve       , Gs^Fms      , Gs^Fms      , Gs^Fms      , Gs^Fms      
Gs^Fms      , Gs^Fms      , Gs^Fms      , Gd          , Gd          , Gd          , Gd          , Gd          , Gd^Fetd     , Gd          , Gd          , Gs^Fms      , Gd          , Gs^Fms      , Gd          , Gs^Fms      , Gll         , Hh^Fms      , Gs^Fms      , Gg^Fet      , Gs^Fms      , Gs^Fms      , Gll         , Gll         , Gs^Fms      , Gs^Fms      , Gs^Fms      , Gs^Fms      , Gs^Fms      , Gll         , Gs^Fms      , Gs^Fms      , Gs^Fms      , Gs^Fms      , Gs^Fms      , Gs^Fms      , Gs^Fms      , Gs^Fms      , Gs^Fms      
Gll         , Gs^Vl       , Gd          , Gd          , Gd          , Gd          , Gd          , Gd          , Gd          , Gd          , Gd          , Gd          , Gd          , Gd          , Gd          , Gs^Fms      , Gs^Fms      , Hh^Fms      , Gs^Fms      , Gs^Fms      , Gs^Fms      , Gs^Fms      , Gs^Fms      , Gs^Fms      , Gs^Fms      , Gll         , Gs^Fms      , Gs^Fms      , Gs^Fms      , Gs^Fms      , Gs^Fms      , Gs^Fms      , Gs^Fms      , Gs^Fms      , Gs^Fms      , Gs^Fms      , Gll         , Gs^Fms      , Gs^Fms      
Gll         , Gd          , Gd          , Gd          , Gd          , Gd^Dr       , Ce          , Gd          , Gd          , Gd          , Gd^Dr       , Gd          , Gd          , Gd          , Gd          , Gs^Fms      , Gs^Fms      , Hh^Fms      , Hh^Fms      , Gll         , Gs^Fms      , Gs^Fms      , Gll         , Gs^Fms      , Gs^Fms      , Gs^Fms      , Gs^Fms      , Gs^Fms      , Gll         , Gs^Fms      , Gs^Fms      , Gs^Fms      , Gs^Fms      , Gs^Fms      , Gs^Fms      , Gs^Fms      , Gs^Fms      , Gs^Fms      , Gs^Fms      
Gll         , Gd          , Gd          , Gd          , Gd          , Ce          , Gd^Vo       , Ce          , Ce          , Gd          , Gd          , Gd          , Gd          , Gd          , Gd          , Gd          , Gd          , Gs^Fms      , Gs^Fms      , Gs^Fms      , Gs^Fms      , Gs^Fms      , Gd^Vo       , Gs^Fms      , Gll         , Gs^Fms      , Gs^Fms      , Gs^Fms      , Gs^Fms      , Gll         , Gs^Fms      , Gs^Fms      , Gs^Fms      , Gs^Fms      , Gs^Fms      , Gll         , Gll         , Gll         , Gs^Fms      
Gll         , Gd          , Ce          , Ce          , Gd          , Gd          , Gd          , Gd          , Gd          , Ce          , Gd          , Gd          , Gd          , Gd^Fetd     , Gd          , Gd          , Gs^Fms      , Gs^Fms      , Gs^Fms      , Gs^Fms      , Hh^Fms      , Gs^Fms      , Gll         , Gs^Fms      , Gs^Fms      , Gll         , Gs^Fms      , Gs^Fms      , Gs^Fms      , Gs^Fms      , Gs^Fms      , Gs^Fms      , Gs^Fms      , Gll         , Gs^Fms      , Gs^Fms      , Gs^Fms      , Gll         , Gs^Fms      
Gd          , Ce          , Gd^Vo       , Gd          , Gd          , Gd^Fetd     , Gd          , Gd          , Gd          , Gd          , Ce          , Gd          , Gd          , Gd          , Gd          , Gd          , Gs^Fms      , Gs^Fms      , Gs^Fms      , Gs^Fms      , Hh^Fms      , Hh^Fms      , Hh^Fms      , Gs^Fms      , Gs^Fms      , Gs^Fms      , Gs^Fms      , Gs^Fms      , Gs^Fms      , Gs^Fms      , Gll         , Gll         , Gs^Fms      , Gll         , Gs^Fms      , Gs^Fms      , Gll         , Gs^Fms      , Gs^Fms      
Gd          , Ce          , Gd          , Gd          , Gd          , Gd          , Gd          , Gd          , Gd          , Gd          , Ce          , Gd          , Gd          , Gd          , Gd          , Gd          , Gll         , Gs^Fms      , Gg^Fet      , Gs^Fms      , Gll         , Hh^Fms      , Gs^Fms      , Gs^Fms      , Gll         , Gs^Fms      , Gs^Fms      , Gs^Fms      , Gs^Fms      , Gll         , Gs^Fms      , Gs^Fms      , Gs^Fms      , Gll         , Gll         , Gs^Fms      , Gll         , Gll         , Gll         
Gll         , 3 Ket       , Ce          , Gd          , Gd          , Gd          , Gd          , Gd          , Gd          , Gs^Vl       , 4 Ke        , Gd^Dr       , Gd          , Gd          , Gd^Vhr      , Gd          , Gs^Fms      , Gs^Fms      , Gll         , Gs^Fms      , Gs^Fms      , Gll         , Gs^Fms      , Hh^Fms      , Hh^Fms      , Gs^Fms      , Gs^Fms      , Gll         , Gs^Fms      , Gs^Fms      , Gs^Fms      , Gs^Fms      , Gll         , Gll         , Gll         , Gll         , Gs^Fms      , Gll         , Gs^Fms      
Gd          , Gd          , Gs^Vl       , Ce          , Ce          , Gd          , Gd          , Gd          , Ce          , Ce          , Gd          , Gd          , Gd^Fetd     , Gd          , Gs^Fms      , Gs^Fms      , Gll         , Gll         , Gll         , Gs^Fms      , Gs^Fms      , Gll         , Gs^Fms      , Hh^Fms      , Gs^Fms      , Gs^Fms      , Gs^Fms      , Gll         , Gll         , Gs^Fms      , Gs^Fms      , Gs^Fms      , Gs^Fms      , Gs^Fms      , Gs^Fms      , Gs^Fms      , Gs^Fms      , Gs^Fms      , Gs^Fms      
Gll         , Gd          , Gd          , Gd          , Gd          , Ce          , Gd          , Ce          , Gd          , Gd          , Gd          , Gd          , Gs^Fms      , Gd          , Gs^Fms      , Gs^Fms      , Gs^Fms      , Gs^Fms      , Gll         , Gll         , Gs^Fms      , Gs^Fms      , Gs^Fms      , Gll         , Gll         , Hh^Fms      , Hh^Fms      , Hh^Fms      , Gs^Fms      , Gs^Fms      , Gs^Fms      , Gs^Fms      , Gs^Fms      , Gg^Ve       , Gs^Fms      , Gs^Fms      , Gs^Fms      , Gs^Fms      , Gs^Fms      
Gll         , Gd          , Gd          , Gd          , Gd          , Gd          , Gd          , Gd          , Gd          , Gd          , Gd          , Gd          , Gs^Fms      , Gs^Fms      , Gs^Fms      , Gs^Fms      , Gll         , Gs^Fms      , Gs^Fms      , Gs^Fms      , Gs^Fms      , Gs^Fms      , Gll         , Gs^Fms      , Gs^Fms      , Gs^Fms      , Gs^Fms      , Hh^Fms      , Gll         , Gs^Fms      , Gll         , Gs^Fms      , Gll         , Gs^Fms      , Gs^Fms      , Gs^Fms      , Gll         , Gs^Fms      , Gs^Fms      
Gs^Fms      , Gs^Fms      , Gs^Fms      , Gs^Fms      , Gs^Fms      , Gs^Fms      , Gs^Fms      , Gs^Fms      , Gs^Fms      , Gd          , Gs^Fms      , Gs^Fms      , Gs^Fms      , Gs^Fms      , Gs^Fms      , Gs^Fms      , Gs^Fms      , Gs^Fms      , Gs^Fms      , Gs^Fms      , Gs^Fms      , Gs^Fms      , Gs^Fms      , Gs^Fms      , Gs^Fms      , Gs^Fms      , Gs^Fms      , Hh^Fms      , Gs^Fms      , Gs^Fms      , Gs^Fms      , Gs^Fms      , Gs^Fms      , Gs^Fms      , Gs^Fms      , Gs^Fms      , Gs^Fms      , Gs^Fms      , Gs^Fms      
